R  1000    800



F         89,151,   8
C 77,    143, 172


NO ./texture/acacia_planks.xpm
SO ./texture/composter_inside.xpm
WE                         ./texture/loom_bottom.xpm

EA                                        ./texture/bricks.xpm
S                     ./texture/mobtr.xpm




        1111111111111111111111111
        1000000000100000000000001
        1011000001110000002000001
        1001000000000000000000001
111111111011000001110000000000001
100000000011000001110111110111111
11110111111111011100000010001
1111011101111101 101010010001
11000000110101011100000010001
10002000000000000000000000201
100000000000000011010100100011
11000001110101011111011110N0011
11110111 1110101 1011110100011
11111111 1111111 111111111111



